111111111111
1E00000C00P1
111111111111